2 2 2 2 5 5 5 5 5 5 5 5 5 5 5 5 5 5 5 5 5 5 5 5 5 5 5 5 5 5 5 5 5 5 5 5 5 5 5 5 5 5 5 5 5 5 5 5 5 5 5 5 5 5 2 2 2 2 2
2 2 2 2 5 5 5 5 5 5 5 5 5 5 5 5 5 5 5 5 5 5 5 5 5 5 5 5 5 5 5 5 5 5 5 5 5 5 5 5 5 5 5 5 5 5 5 5 5 5 5 5 5 5 2 2 2 2 2
2 2 2 2 5 5 5 5 5 5 5 5 5 5 5 5 5 5 5 5 5 5 5 5 5 5 5 5 5 5 5 5 5 5 5 5 5 5 5 5 5 5 5 5 5 5 5 5 5 5 5 5 5 5 2 2 2 2 2
2 2 2 2 5 5 5 5 5 5 5 5 5 5 5 5 5 5 5 5 5 5 5 5 5 5 5 5 5 5 5 5 5 5 5 5 5 5 5 5 5 5 5 5 5 5 5 5 5 5 5 5 5 5 2 2 2 2 2
2 2 2 2 2 2 2 2 2 2 2 2 2 2 2 2 2 4 4 4 4 4 4 4 4 4 4 4 4 4 4 4 4 4 4 4 4 4 4 4 4 4 4 2 2 2 2 2 2 2 2 2 2 2 2 2 2 2 2
2 2 2 2 2 2 2 2 2 2 2 2 2 2 2 2 2 2 4 4 4 4 4 4 4 4 4 4 4 4 4 4 4 4 4 4 4 4 4 2 2 2 2 2 2 2 2 2 2 2 2 2 2 2 2 2 2 2 2
2 2 2 2 2 2 2 2 2 2 2 2 2 2 2 2 2 2 4 4 4 0 0 0 0 3 3 3 3 3 3 3 0 0 0 0 0 0 0 0 0 2 2 2 4 4 4 2 2 2 2 2 2 2 2 2 2 2 2
2 2 2 2 2 2 2 2 2 2 2 2 2 2 2 2 2 2 4 4 4 4 4 4 0 3 3 3 3 3 3 3 0 4 4 4 4 4 4 2 0 0 0 0 0 0 4 2 2 2 2 2 2 2 2 2 2 2 2
2 2 2 2 2 2 2 2 2 2 2 2 2 2 2 2 2 2 2 2 2 2 4 4 0 3 3 3 3 3 3 3 0 4 4 2 2 2 2 2 2 2 2 2 4 0 4 2 2 2 2 2 2 2 2 2 2 2 2
2 2 2 2 2 2 2 2 2 2 2 2 2 2 2 2 2 2 2 2 2 2 2 4 0 3 3 3 3 3 3 3 0 4 2 2 2 2 2 2 2 2 2 2 4 0 4 2 2 2 2 2 2 2 2 2 2 2 2
2 2 2 2 2 2 2 2 2 2 2 2 2 2 2 2 2 2 2 2 2 2 2 4 0 3 3 3 3 3 3 3 0 4 2 2 2 2 2 2 2 2 2 2 4 0 4 2 2 2 2 2 2 2 2 2 2 2 2
2 2 2 2 2 2 2 2 2 2 2 2 2 2 2 2 2 2 2 2 2 2 2 4 0 3 3 3 3 3 3 3 0 4 2 2 2 2 2 2 2 2 2 2 4 0 4 2 2 2 2 2 2 2 2 2 2 2 2
2 2 2 2 2 2 2 2 1 1 1 1 1 1 1 1 1 1 1 1 1 1 1 1 9 6 6 6 6 6 6 6 9 1 1 1 1 1 1 1 1 1 1 1 1 1 1 1 1 1 2 2 2 2 2 2 2 2 2
2 2 2 2 2 2 2 2 1 7 7 7 7 7 7 7 7 7 7 7 7 7 7 7 1 6 6 6 6 6 6 6 1 7 7 7 7 7 7 7 7 7 7 7 7 7 7 7 7 1 2 2 2 2 2 2 2 2 2
2 2 2 2 2 2 2 2 1 7 7 7 7 7 7 7 7 7 7 7 7 7 7 7 1 6 6 6 6 6 6 6 1 7 7 7 7 7 7 7 7 7 7 7 7 7 7 7 7 1 2 2 2 2 2 2 2 2 2
2 2 2 2 2 2 2 2 1 7 7 7 7 7 7 7 7 7 7 7 7 7 7 7 1 6 6 6 6 6 6 6 1 7 7 7 7 7 7 7 7 7 7 7 7 7 7 7 7 1 2 2 2 2 2 2 2 2 2
2 2 2 2 2 2 2 2 1 7 7 7 7 7 7 7 7 7 7 7 7 7 7 7 1 6 6 6 6 6 6 6 1 7 7 7 7 7 7 7 7 7 7 7 7 7 7 7 7 1 2 2 2 2 2 2 2 2 2
2 2 2 2 2 2 2 2 1 7 7 7 7 7 7 7 7 7 7 7 7 7 7 7 7 6 6 6 6 6 6 6 7 7 7 7 7 7 7 7 7 7 7 7 7 7 7 7 7 1 2 2 2 2 2 2 2 2 2
2 2 2 2 2 2 2 2 1 7 7 7 7 7 7 7 7 7 7 7 7 7 7 7 1 6 6 6 6 6 6 6 1 7 7 7 7 7 7 7 7 7 7 7 7 7 7 7 7 1 2 2 2 2 2 2 2 2 2
2 2 2 2 2 2 2 2 1 7 7 7 7 7 7 7 7 7 7 7 7 7 7 7 1 6 6 6 6 6 6 6 1 7 7 7 7 7 7 7 7 7 7 7 7 7 7 7 7 1 2 2 2 2 2 2 2 2 2
2 2 2 2 2 2 2 2 1 1 1 1 1 1 1 1 1 1 1 1 1 1 1 1 9 6 6 6 6 6 6 6 9 1 1 1 1 1 1 1 1 1 1 1 1 1 1 1 1 1 2 2 2 2 2 2 2 2 2
2 2 2 2 2 2 2 2 1 8 8 2 2 2 2 2 2 2 2 2 2 2 2 2 11 6 6 6 6 6 6 6 8 8 8 8 8 4 4 4 4 8 8 8 8 8 8 8 8 1 2 2 2 2 2 2 2 2 2
2 2 2 2 2 2 2 2 1 8 8 2 2 2 2 2 2 2 2 2 2 2 2 2 11 6 6 6 6 6 6 6 8 8 8 8 8 8 8 8 8 8 8 8 8 8 8 8 8 1 2 2 2 2 2 2 2 2 2
2 2 2 2 2 2 2 2 1 8 8 2 2 2 2 2 2 2 2 2 2 2 2 2 11 6 6 6 6 6 6 6 8 8 8 8 8 8 8 8 8 8 8 8 8 8 8 8 8 1 2 2 2 2 2 2 2 2 2
2 2 2 2 2 2 2 2 1 8 8 2 2 2 2 2 2 2 2 2 2 2 2 2 11 6 6 6 6 6 6 6 8 8 8 8 8 8 8 8 8 8 8 8 8 8 8 8 8 1 2 2 2 2 2 2 2 2 2
2 2 2 2 2 2 2 2 1 8 8 1 1 1 1 1 1 1 1 1 1 1 1 1 11 11 11 11 11 11 11 11 11 8 8 8 8 8 4 4 4 4 8 8 8 8 8 8 8 1 2 2 2 2 2 2 2 2 2
2 2 2 2 2 2 2 2 1 1 1 1 1 1 1 1 1 1 1 1 1 1 1 1 9 6 6 6 6 6 6 6 1 1 1 1 1 1 1 1 1 1 1 1 8 8 1 1 1 1 2 2 2 2 2 2 2 2 2
2 2 2 2 2 2 2 2 1 7 7 7 7 7 7 7 7 7 7 7 7 7 7 7 1 6 6 6 6 6 6 6 1 2 2 2 2 2 2 2 2 2 2 1 0 0 1 2 2 1 2 2 2 2 2 2 2 2 2
2 2 2 2 2 2 2 2 1 7 7 7 7 7 7 7 7 7 7 7 7 7 7 7 1 6 6 6 6 6 6 6 1 2 2 2 2 2 2 2 2 2 2 1 0 0 1 2 2 1 2 2 2 2 2 2 2 2 2
2 2 2 2 2 2 2 2 1 7 7 7 7 7 7 7 7 7 7 7 7 7 7 7 1 6 6 6 6 6 6 6 1 2 2 2 2 2 2 2 2 2 2 1 0 0 1 2 2 1 2 2 2 2 2 2 2 2 2
2 2 2 2 2 2 2 2 1 7 7 7 7 7 7 7 7 7 7 7 7 7 7 7 1 6 6 6 6 6 6 6 1 2 2 2 2 2 2 2 2 2 2 1 0 0 1 2 2 1 2 2 2 2 2 2 2 2 2
2 2 2 2 2 2 2 2 1 7 7 7 7 7 7 7 7 7 7 7 7 7 7 7 1 6 6 6 6 6 6 6 1 1 1 1 1 1 1 1 1 1 1 1 0 0 1 2 2 1 2 2 2 2 2 2 2 2 2
2 2 2 2 2 2 2 2 1 7 7 7 7 7 7 7 7 7 7 7 7 7 7 7 7 6 6 6 6 6 6 6 0 0 0 0 0 0 0 0 0 0 0 0 0 0 1 2 2 1 2 2 2 2 2 2 2 2 2
2 2 2 2 2 2 2 2 1 7 7 7 7 7 7 7 7 7 7 7 7 7 7 7 7 6 6 6 6 6 6 6 1 1 1 1 1 1 1 1 1 1 1 1 1 1 1 2 2 1 2 2 2 2 2 2 2 2 2
2 2 2 2 2 2 2 2 1 7 7 7 7 7 7 7 7 7 7 7 7 7 7 7 1 6 6 6 6 6 6 6 1 2 2 2 2 2 2 2 2 2 2 2 2 2 2 2 2 1 2 2 2 2 2 2 2 2 2
2 2 2 2 2 2 2 2 1 7 7 7 7 7 7 7 7 7 7 7 7 7 7 7 1 6 6 6 6 6 6 6 1 2 2 2 2 2 2 2 2 2 2 2 2 2 2 2 2 1 2 2 2 2 2 2 2 2 2
2 2 2 2 2 2 2 2 1 7 7 7 7 7 7 7 7 7 7 7 7 7 7 7 1 6 6 6 6 6 6 6 1 2 2 2 2 2 2 2 2 2 2 2 2 2 2 2 2 1 2 2 2 2 2 2 2 2 2
2 2 2 2 2 2 2 2 1 7 7 7 7 7 7 7 7 7 7 7 7 7 7 7 1 6 6 6 6 6 6 6 1 2 2 2 2 2 2 2 2 2 2 2 2 2 2 2 2 1 2 2 2 2 2 2 2 2 2
2 2 2 2 2 2 2 2 1 7 7 7 7 7 7 7 7 7 7 7 7 7 7 7 1 6 6 6 6 6 6 6 1 2 2 2 2 2 2 2 2 2 2 2 2 2 2 2 2 1 2 2 2 2 2 2 2 2 2
2 2 2 2 2 2 2 2 1 1 1 1 1 1 1 1 1 1 1 1 1 1 1 1 9 6 6 6 6 6 6 6 1 2 2 2 2 2 2 2 2 2 2 2 2 2 2 2 2 1 2 2 2 2 2 2 2 2 2
2 2 2 2 2 2 2 2 1 2 2 2 2 2 2 2 2 2 2 2 2 2 2 2 2 6 6 6 6 6 6 6 2 2 2 2 2 2 2 2 2 2 2 2 2 2 2 2 2 1 2 2 2 2 2 2 2 2 2
2 2 2 2 2 2 2 2 1 2 2 2 2 2 2 2 2 2 2 2 2 2 2 2 2 6 6 6 6 6 6 6 2 2 2 2 2 2 2 2 2 2 2 2 2 2 2 2 2 1 2 2 2 2 2 2 2 2 2
2 2 2 2 2 2 2 2 1 2 2 2 2 2 2 2 2 2 2 2 2 2 2 2 2 6 6 6 6 6 6 6 2 2 2 2 2 2 2 2 2 2 2 2 2 2 2 2 2 1 2 2 2 2 2 2 2 2 2
2 2 2 2 2 2 2 2 1 2 2 2 2 2 2 2 2 2 2 2 2 2 2 2 2 6 6 6 6 6 6 6 2 2 2 2 2 2 2 2 2 2 2 2 2 2 2 2 2 1 2 2 2 2 2 2 2 2 2
2 2 2 2 2 2 2 2 1 2 2 2 2 2 2 2 2 2 2 2 2 2 2 2 2 6 6 6 6 6 6 6 2 2 2 2 2 2 2 2 2 2 2 2 2 2 2 2 2 1 2 2 2 2 2 2 2 2 2
2 2 2 2 2 2 2 2 1 2 2 2 2 2 2 2 2 2 2 2 2 2 2 2 2 6 6 6 6 6 6 6 2 2 2 2 2 2 2 2 2 2 2 2 2 2 2 2 2 1 2 2 2 2 2 2 2 2 2
2 2 2 2 2 2 2 2 1 1 1 1 1 1 1 1 1 1 1 1 1 1 1 1 1 6 6 6 6 6 6 6 1 1 1 1 1 1 1 1 1 1 1 1 1 1 1 1 1 1 2 2 2 2 2 2 2 2 2
2 2 2 2 2 2 2 2 2 2 2 2 2 2 2 2 2 2 2 2 2 2 2 2 2 3 3 3 3 3 3 3 2 2 2 2 2 2 2 2 2 2 2 2 2 2 2 2 2 2 2 2 2 2 2 2 2 2 2
2 2 2 2 2 2 2 2 2 2 2 2 2 2 2 2 2 2 2 2 2 2 2 2 2 3 3 3 3 3 3 3 2 2 2 2 2 2 2 2 2 2 2 2 2 2 2 2 2 2 2 2 2 2 2 2 2 2 2
2 2 2 2 2 2 2 2 2 2 2 2 2 2 2 2 2 2 2 2 2 2 2 2 2 3 3 3 3 3 3 3 2 2 2 2 2 2 2 2 2 2 2 2 2 2 2 2 2 2 2 2 2 2 2 2 2 2 2
2 2 2 2 2 2 2 2 2 2 2 2 2 2 2 2 2 2 2 2 2 2 2 2 2 3 3 3 3 3 3 3 2 2 2 2 2 2 2 2 2 2 2 2 2 2 2 2 2 2 2 2 2 2 2 2 2 2 2
2 2 2 2 2 2 2 2 2 2 2 2 2 2 2 2 2 2 2 2 2 2 2 2 2 3 3 3 3 3 3 3 2 2 2 2 2 2 2 2 2 2 2 2 2 2 2 2 2 2 2 2 2 2 2 2 2 2 2
2 2 2 2 2 2 2 2 2 2 2 2 2 2 2 2 2 2 2 2 2 2 2 2 2 3 3 3 3 3 3 3 2 2 2 2 2 2 2 2 2 2 2 2 2 2 2 2 2 2 2 2 2 2 2 2 2 2 2
2 2 2 2 2 2 2 2 2 2 2 2 2 2 2 2 2 2 2 2 2 2 2 2 2 3 3 3 3 3 3 3 2 2 2 2 2 2 2 2 2 2 2 2 2 2 2 2 2 2 2 2 2 2 2 2 2 2 2
2 2 2 2 2 2 2 2 1 1 1 1 1 1 1 1 1 1 1 1 1 1 1 1 8 6 6 6 6 6 6 6 2 2 2 2 2 2 2 2 2 2 2 2 2 2 2 2 2 1 2 2 2 2 2 2 2 2 2
2 2 2 2 2 2 2 2 1 2 2 2 2 2 2 2 2 2 2 2 2 2 2 2 2 6 6 6 6 6 6 6 2 2 2 2 2 2 2 2 2 2 2 2 2 2 2 2 2 1 2 2 2 2 2 2 2 2 2
2 2 2 2 2 2 2 2 1 2 2 2 2 2 2 2 2 2 2 2 2 2 2 2 2 6 6 6 6 6 6 6 2 2 2 2 2 2 2 2 2 2 2 2 2 2 2 2 2 1 2 2 2 2 2 2 2 2 2
2 2 2 2 2 2 2 2 1 2 2 2 2 2 2 2 2 2 2 2 2 2 2 2 2 6 6 6 6 6 6 6 2 2 2 2 2 2 2 2 2 2 2 2 2 2 2 2 2 1 2 2 2 2 2 2 2 2 2
2 2 2 2 2 2 2 2 1 2 2 2 2 2 2 2 2 2 2 2 2 2 2 2 2 6 6 6 6 6 6 6 2 2 2 2 2 2 2 2 2 2 2 2 2 2 2 2 2 1 2 2 2 2 2 2 2 2 2
2 2 2 2 2 2 2 2 1 2 2 2 2 2 2 2 2 2 2 2 2 2 2 2 2 6 6 6 6 6 6 6 2 2 2 2 2 2 2 2 2 2 2 2 2 2 2 2 2 1 2 2 2 2 2 2 2 2 2
2 2 2 2 2 2 2 2 1 2 2 2 2 2 2 2 2 2 2 2 2 2 2 2 2 6 6 6 6 6 6 6 2 2 2 2 2 2 2 2 2 2 2 2 2 2 2 2 2 1 2 2 2 2 2 2 2 2 2
2 2 2 2 2 2 2 2 1 1 1 1 1 1 1 1 1 1 1 1 1 1 1 1 1 6 6 6 6 6 6 6 1 1 1 1 1 1 1 1 1 1 1 1 1 1 1 1 1 1 2 2 2 2 2 2 2 2 2
2 2 2 2 5 5 5 5 5 5 5 5 5 5 5 5 5 5 5 5 5 5 5 5 5 5 5 5 5 5 5 5 5 5 5 5 5 5 5 5 5 5 5 5 5 5 5 5 5 5 5 5 5 5 2 2 2 2 2
2 2 2 2 5 5 5 5 5 5 5 5 5 5 5 5 5 5 5 5 5 5 5 5 5 5 5 5 5 5 5 5 5 5 5 5 5 5 5 5 5 5 5 5 5 5 5 5 5 5 5 5 5 5 2 2 2 2 2
2 2 2 2 5 5 5 5 5 5 5 5 5 5 5 5 5 5 5 5 5 5 5 5 5 5 5 5 5 5 5 5 5 5 5 5 5 5 5 5 5 5 5 5 5 5 5 5 5 5 5 5 5 5 2 2 2 2 2
2 2 2 2 5 5 5 5 5 5 5 5 5 5 5 5 5 5 5 5 5 5 5 5 5 5 5 5 5 5 5 5 5 5 5 5 5 5 5 5 5 5 5 5 5 5 5 5 5 5 5 5 5 5 2 2 2 2 2
2 2 2 2 5 5 5 5 5 5 5 5 5 5 5 5 5 5 5 5 5 5 5 5 5 5 5 5 5 5 5 5 5 5 5 5 5 5 5 5 5 5 5 5 5 5 5 5 5 5 5 5 5 5 2 2 2 2 2